12
20
........!...........
A........+++++++A...
....++++++++...+++++
B........******...B.
......+++########...
......######.......#
...........#####....
E.........@.........
....................
....................
........&&&......E..
........&$&.........

