8
20
Az..................
#################+#.
..................#.
@.................#.
..............A...#.
..................#.
..................#.
..................#$
