9
15
@.....D........
.#############.
.############..
g#############B
.#....$5...zA#.
C#############.
.#############.
A#############.
..B..C....D....
